66
-10 10 60
1 1 1 1 1 0
2 0 2 2 1 4
1 1 1 2 0 4
3 2 3 2 0 4
3 2 1 1 2 4
3 2 0 1 2 4
0 1 1 0 0 0
