41
3 5 7
1 1 1 1 1 0
1 0 2 2 1 0
1 1 1 2 0 0
1 3 4 0 1 0
3 2 1 1 1 0
0 2 0 0 2 1
0 1 1 0 1 0
